TOP'S LEVEL
134 x 19
1111111111111111111111111111111111111111111111111111111111111111111111111111111111111111111111111111111111111111111111111111111111111
1                                  1                                                                                 8# 2     C     3                                                                                                                                                                                                                                           
1  2       C             2         1                             2        C        2  2     C      2                 8              1                                                                                                                                                                                                                                                            
1                                  1111111111111711111111111111                                                      11111111111111 1                                                                                                                                                                                                                                                                                  
1       77  1                      1             1            1    77         13  5 3 5  31         11       11                     1                                                                                                                                                                                                                                                           
1           1  2  B   2            1             1            1           D                                                         1                                                                                                                                                                                                                                 
1           1  2      2            1 111111111111111111111111 1                                                   7              1111                                                                                                                                                                                                                                                                             
1           1   1111112  C         3                          1          111                   11        11                         1                                                                                                                                                                                                                                                                        
11111       1                      1                          1                                                          11   77    1                                                                                                                                                                                                                                                   
1           1              111     1111111111111111711111111111                                                                     1                                                                                                                                                                                                                                                               
1           1                   D                   1              111                                                              1                                                                                                                                                                                                                                                
1     11111 1                                       1M                                                             77    D          1                                                                                                                                                                                                                                                          
3 B         1       1111        111111111111111111111111111111111  2       C              2   D      2  B    2                      1                                                                                                                                                                                                                                                                                         
3    2      1                 111                            11                                      2       2           11   77    1                                                                                                                                                                                                                                                                 
11111       1 77            111                              11                              113  5  31111111  7                    1                                                                                                                                                                                                                                                                   
1           1             111    H                           88                             11                            B       111                                                                                                                                                                                                                                                                   
3*      B   3           888      1          2  B   2         88D           2   B   2       11         D         2                   3                                                                                                                                                                                                                                                                   
3           3         111                   2      2         11            2       2      11                    2                   3                                                                                                                                                                                                                                                                                                                                                                                                                                                                                                                                                                                                                                                           
1111111111XX1XXXX111111111111111XXX11111111  111111  111111111111111111XXXXX1111111XXXXX111111111     11111111XXX11111111111111111111































