top's level2
50 x 64 
1111111111111111111111111111111111111111111111111
11                                             11                                             
13                                             31
11                                             11
13                   C         2D              11
11#     B            B                         11
11  2                    2 111  111 D          31
1111111111111111111111111       111            11
1111111111111111111111111       11111111177    11
1111111111111111111111111                      11 
1111111111888888888888888                      11
1111111111H88888M888888882         C     2  11111	
1111111111111111111888888                      11
1111111111111111111111111                      11
11111111111111111111111111    1111111111111111111         
11                            111              11
11                            111              11 
11  B                B     7  111              11
112  2             2  2       111       D      11
11 111    111       11      11113              31
13      C      31             111       111    11
11                     11     113   C   3      31
11         XXXXXXXXXXX   C    311       1     111
11 1111    Y111111111W      11111       1      11
11         Y111111111W        111       1  11  11
11     B   Y11 111 11W        111       1D     11
13   2   2 Y11 111 11W       H111       1      11
11    111  Y111111111111111111111       11     11
11         Y111111111W                  1      11
11         Y11 111 11W                  1      11
11         Y111   111W                  1 11   11
11 113 C   Y311111113W    C     C       3      11
11         ZZZZZZZZZZZ             111  3 B    11
11                                      3   2  11
11                                      1111   11
11  1113     C                          3      11
11                                      1      11
13       B     B                 B      1      11
13                      2     2    2    1  11  11
11111111111111111111111111111111111111111      11
11W                                     1      11
11W                                     3    3111
11W            B         D       B            D31
11W       2      2                             31
11W11   11111111111111111111111111111111111111111
11W   B   Y111                                 11
11W 2   2 Y111M                                11
11W  111  Y11111111    2        C              31
11W       Y11111111D                           31
11W       Y11111111                            11
11W       Y111111111111        11111XXX11      11
11W11   11Y111111111111     D  11111111111     11
11W       Y111111111111        1111111111      11
11W   D   Y111111111111   1111111              11
11W       Y111111111111   1111111            1111
11W  111  Y113 C        B 3     1      111     11
11W       Y113      2     3     1              31
11W B   B Y111       111113     1              31
11W  2 2  Y111                  1  111         11
11W11   111111                  1              11
11W                             1        D     11
11W                 B        B  3D           * 11
11W   2                         3      1111    11
1111111111111111111111111111111111111111111111111