Donut's Level2
123 x 23
111111111111111111111111111111111111111111111111111111111111111111111111111111111111111111111111111111111111111111111111111
1                                                                                                                         1
1                                                                                                                M        1
1                                                                                                              D          1
1                                                                                                                         1
1                                                                                                              1111       1
1                                                                                                                         1
1                                                                                                                   777   1
1                                                                                                                        D1
1                                                                                                                         1
1                                                                                                                     11111
1                                                                                                                         1
1                                                                                                                         1
1                                                                                                                  7777   1
1               D     B    2      C   2                    2        C    2           C    2         C    2      D         1
1            2                                                                                                            1
1             1111111111111111    1111111  777  11111113    3 5    3   3111136  5  3 5   6  5  3  5  6 5   311111         1
1             1              1    1     1       1      1               1    1                              1    11        1
1       7777  1              1    1     1       1      1               1    1                              1    111       1
1             1              1    1     1       1      1777         7771    1           77777              1    1111      1
1 *           1              1    1     1       1      1               1    1       2  B          D 2      1    11111   # 1
1             1              1    1     1       1      1H              1    1       2       H       2      1    111111    1
111111111111111              1    1     1       1      11111       11111    1        111111111111111       1    11111111111