Donut's Level
135 x 20
11111111111111111111111111111111111111111111111111111111111111111111111111111111111111111111111111111111111111111111111111111111111111
1                                                                       1                                                            1
1                                                                       1                                                            1
1                                                                       3M      C      2                                             1
1                                                                       11                                                           1
1                                                                       1                   1   11   1                               1
1                               2      C      2      C    2     C   2   7            B                      B           B           H3
1                                                                       7 2             2   XXXXXXXXXX                               3
1                          1    1    1    1    1    1    1    1    1    11111111111111111111111111111111111111111111111111111111111111
1                                                                                                                                    1
1                                                                                                                                    1
1                                                                                                                                    1
1                      1               B                   B                                                                         1
1                                   2      2            2      2                                                                     1
1                          111111    111111    111111    111111    111113              C  2                                          1
1                                                                      113                        C 2                                1
3  *          B    1                                                   1113                           B               B          #   1
3              2          XXXXXXXXXXXXXXXXXXXXXXXXXXXXXXXXXXXXXXXXXXXXX11113                 XX            XX           XX           1
11111111111111111111111111111111111111111111111111111111111111111111111111111111111111111111111111111111111111111111111111111111111111
11111111111111111111111111111111111111111111111111111111111111111111111111111111111111111111111111111111111111111111111111111111111111