Mai's level
169 x 12
111111111111111111111111111111111111111111111111111111111111111111111111111111111111111111111111111111111111111111111111111111111111111111111111111111111111111111111111
11                                                                                                                                                                   111
11                           2  B   2 2  B  2                                              2  B 2 2 B  2 2  B   2                                                    111								
11                                                                                                            H                                                      111	
11                   11       111111   11111   11                                      11   1111   1111   11111                                                      111
11                                                                                  1                                                                                111
11              111      11                               11                                                            1111                                         111
11                                                        111                    1                         1111          11111                                       111
11  *  2   B     2    B      2   B     2          2    B  3111     2    B   2    B      2       2  B    2 11111    2   B 2 1111 2 B   2                 2    B   2 # 111
11                                                        31111                                          111111	          M11111                                     111
1111111111111111111111111111111111111111XXX1111XXX11111111111111XXX1111111111111111111111111XXX1111111111111111XXX11111111111111111111  11  11  11  11  1111111111111111
11111111111111111111111111111111111111111111111111111111111111111111111111111111111111111111111111111111111111111111111111111111111111XXXXXXXXXXXXXXXXXX1111111111111111