donut's level3
105 x 33
11111111111111111111111111111111111111111111111111111111111111111111111111111111111111111111111111111111
1                     1                     1                                     8                    1
1                     1                     1                                     82   C    2          1
1                     8 2 C    2            1                                     8                    1
1                     8                     1                                     11113      C   2     3
1                     1         2 C     2   8                             D 7777  1111113              3
1              7777   1                     8             D 6 5 616 5 6         11111111113    C    2  3
1                     3     B         B     3                           111       11111111113     # D  3
1                     3                     31111111111111111XXXXXXXXXXXXXXXXXXXXX1111111111113        1
1  7777 111111111111111111111111111111111111111111111111111111111111111111111111111111111111111111111111
1                  ZZZZZZZZZZZZZZZZZZZZZZZZZZZZZZZZZZZZZZZZZZZZZZZZZZZZZZZZZZZZZZZZZZZ                 1
1                                                                                                  D   1
1  1111                           2     C    2      C      2      C    2                             H 1
1                               B               D             B                                  1111111
1                            2            2              2               2                             1
1                             11111111111111111111111111111111111111111111                             1
1  7777                       1188888888888            8888888888888888772                    7777     1
1              D             D1188888888888            8888888888888888772B        2   D               1
1                             1188888888888 M          8888888888888888772         2                   1
11111111111111111111111111111111111111111111111111111111111111111111111111111111111111111111111        1
1                                                               88888888                    111  777   1
1                          2  C  2         2  C  2             D88888888               D    111        1
1                                                               88888888                    111       11
1                   77777   11111   77777   11111   77777   11111111111111111  777771111    888   777  1
1       D      B  3                                                                    1    888        1
1         2       3XXXXXXXXXXXXXXXXXXXXXXXXXXXXXXXXXXXXXXXXXXXXXXXXXXXXXXXXXXXXXXXXXXXX1    111        1
1    111111111111111111111111111111111111111111111111111111111111111111111111111111111111111111111111111
1                                                                                                      1
1                    D         2   C   2         2      C   2                                          1
1777                                                                                                   1
3      B    B        33 5  3 5  31111111   77777  1111111113  5 3  5 3  5 3  B      B     B     *      3
3                    3                                                    3                            3
1111111111111111111111                                                    111111111111111111111111111111